111111111111111111
1P0100C00001100C01
100C0000C001000001


11C0000000000100E1
111111111111111111