111111111
100100001
10P000001
100000111
1000001E1
111111111