111111111
1P0100C01
100000001
10C000XX1
1X00100E1
111111111