111111111111111111
1P01X0C000X1100C01
100C0000C001000X01
11C00XX000000100E1
111111111111111111