1111111111111
1P01X0C000001
100C0000C00X1
10C000E00X001
1000100XX0C01
1111111111111