111111111
1P0100C01
100000001
10C000E01
100010001
111111111