1111111111111
1P0100C000001
100C0000C0001
10C000E000001
1000100000C01
1111111111111