111111111
100100C01
10P000001
10C000111
1000001E1
111111111