111111111
100100C01
10P000001
10C00P111
1000001E1
111111111