111111111
1P010
100000001
10C0
100010001
111111111