111111111
1P0100C01
100000001
10C000001
100P10001
111111111